Nigel	Owens
Omar	Bradshaw
Nerea	Wood
Todd	Mitchell
Joel	Church
Ignatius	Strickland
Florence	Griffith
Ethan	Barron
Neil	Gutierrez
Sacha	Farmer
Nehru	Berg
Cameron	Figueroa
Benedict	Galloway
Ruth	Hill
Demetrius	Page
Evelyn	Sims
Timon	Lyons
Lenore	Todd
Robert	Higgins
Elliott	Tyson
Joan	Mayer
Nissim	Mcdaniel
Molly	Flowers
Daquan	Shelton
Teegan	Alvarado
Ivory	Miranda
Quinn	Gillespie
Vincent	Levy
Nerea	Mcintosh
Allistair	Hebert
Laith	Odonnell
Tana	Steele
Patrick	Hubbard
Lucius	Moreno
Dolan	Cummings
Shellie	Suarez
Jaden	Ellison
Hayes	Patton
Jordan	Wiley
Kelly	Cotton
Tanya	Collins
Talon	Thomas
Aquila	Alston
Mollie	Dawson
Aimee	Sawyer
Nita	Gardner
Kevin	Wise
Jana	Fitzgerald
Inez	Barry
Myra	Russo
Hoyt	Harper
Emmanuel	Moses
Maisie	Reynolds
Aretha	Parsons
Devin	Barrett
Stephen	Hodge
Karen	Little
Gabriel	Ashley
Rowan	Walter
Mallory	Compton
Xavier	Pitts
Travis	Jefferson
Reed	Mcdonald
Caryn	Pearson
Brennan	Morse
Jenette	Meadows
Athena	Collins
Julian	Jacobs
Josiah	Mckenzie
Shellie	Cochran
Aphrodite	Dunlap
Brittany	Glass
Macy	Floyd
Catherine	Mcdaniel
Tatum	Cabrera
Hall	Barker
Emmanuel	Boyle
Rebekah	Montgomery
Miriam	Conway
Grant	Santiago
Quin	Madden
Rachel	Rios
Charles	Good
Jessica	Benson
Olivia	Pratt
Rogan	Jennings
Remedios	Clark
Inga	Le
Xander	Sheppard
Cairo	Cabrera
Zephr	Mckay
Keegan	Griffin
Maris	Glover
Julie	Mcdowell
Sage	Hewitt
Caesar	Evans
Aubrey	Gray
Colin	Blevins
Axel	Mooney
Graiden	Callahan

